0 0 0 0 0 0 0 0 0 0 0 0 0 0 0 0
0 1 1 1 1 1 1 1 1 6 1 1 1 1 1 0
0 1 0 0 0 0 0 1 0 0 0 0 1 0 1 0
0 1 0 1 1 1 0 1 0 1 1 0 1 0 1 0
0 1 0 4 0 1 0 1 0 0 1 0 1 0 1 0
0 1 0 1 0 1 0 1 0 1 1 0 5 0 1 0
0 1 0 1 0 1 0 1 0 1 0 0 1 0 1 0
0 1 2 1 1 1 2 1 1 2 1 1 2 1 1 0
0 1 6 1 2 1 1 1 1 1 1 2 1 1 1 0
0 2 0 0 0 0 0 1 0 0 0 0 1 0 1 0
0 1 0 1 1 2 0 1 0 2 1 0 1 0 1 0
0 1 0 1 0 1 0 1 0 0 1 0 1 0 1 0
0 1 0 1 0 1 0 1 0 1 1 0 1 0 1 0
0 1 0 1 0 1 0 1 0 1 0 0 1 0 1 0
0 3 1 2 1 2 1 2 1 2 1 2 1 1 2 0
0 0 0 0 0 0 0 0 0 0 0 0 0 0 0 0