0000000000000000
0111111111111110
0101000000000010
0101111111111110
0101010000001010
0101011111111010
0101010400101010
0101010226101010
0101011220101010
0101010050101010
0101111111101010
0101000000101010
0111111111111010
0100000000001010
0311111111111110
0000000000000000
