0000000000000000
0211111111111140
0100100000010010
0100100000010010
0111111111111110
0100100101010010
0111100101111110
0100111120010010
0100100211110010
0111111010011110
0100101010010010
0111111111111110
0100100000010010
0100100000010010
0311111111111150
0000000000000000
