0000000000000000
0111111111111110
0101000000001010
0111111111111110
0101001001001010
0101011111101010
0101010600111010
0101110224101010
0101014220101010
0101110050111010
0101011111101010
0101001001001010
0111111111111110
0101000000001010
0311111111111110
0000000000000000
